###########
#.........#
#.........#
#..#..#...#
#..#..#...#
#..#..#...#
\robot 1 0
\robot 4 0